15 15
_ W _ # _ _ k _ _ _ _ _ _ _ _
_ # _ # _ _ _ H _ _ _ # K # #
_ # K # _ k _ _ _ _ _ _ # k _
_ # # # _ # # # P _ _ _ _ _ _
_ _ _ _ _ # I _ _ _ _ _ _ _ #
_ _ _ _ _ # # # _ _ H _ _ _ _
_ k _ _ _ _ _ _ _ _ _ _ _ _ _
_ _ _ _ _ _ _ _ # # # # # # #
_ _ _ # # _ # _ # K _ _ _ _ _
_ # # # # _ _ _ # # # # # _ _ 
_ _ _ # # # # _ _ _ _ _ # k _
_ _ _ _ _ # # _ _ _ _ _ # k _
# # _ _ _ _ # _ _ _ _ _ # # _
D # # k _ k # _ _ _ _ _ _ # _
_ _ L _ _ _ _ _ _ _ _ _ _ _ _